The	the	The
expectations	expect	expectation
were	were	were
high	high	high
for	for	for
Ivanka	ivanka	Ivanka
Trump	trump	Trump
s	s	s
speech	speech	speech
and	and	and
she	she	she
far	far	far
exceeded	exceed	exceeded
them	them	them
with	with	with
her	her	her
grace	grace	grace
,	,	,
class	class	class
and	and	and
great	great	great
delivery	deliveri	delivery
of	of	of
an	an	an
introduction	introduct	introduction
of	of	of
her	her	her
father	father	father
.	.	.

Brava	brava	Brava
!	!	!

