Token	Stem	Lemma
WATCH	watch	WATCH
Even	even	Even
her	her	her
friends	friend	friend
on	on	on
the	the	the
Left	left	Left
appear	appear	appear
to	to	to
be	be	be
fed	fed	fed
up	up	up
with	with	with
Hillary	hillari	Hillary
s	s	s
lies	lie	lie
Is	is	Is
it	it	it
possible	possibl	possible
the	the	the
media	media	medium
has	has	ha
finally	final	finally
grown	grown	grown
tired	tire	tired
of	of	of
covering	cover	covering
for	for	for
Hillary	hillari	Hillary
