21st	21st	21st
Century	centuri	Century
Wire	wire	Wire
asks	ask	asks
HAVE	have	HAVE
YOUR	your	YOUR
SHOUT	shout	SHOUT
We	we	We
ask	ask	ask
our	our	our
readers	reader	reader
who	who	who
they	they	they
trust	trust	trust
with	with	with
foreign	foreign	foreign
policy	polici	policy
,	,	,
Hillary	hillari	Hillary
or	or	or
Trump	trump	Trump
?	?	?
Vote	vote	Vote
,	,	,
comment	comment	comment
and	and	and
share	share	share
below	below	below
