Gloria	gloria	Gloria
Steinem	steinem	Steinem
does	doe	doe
pretty	pretti	pretty
much	much	much
everything	everyth	everything
she	she	she
can	can	can
to	to	to
prove	prove	prove
she	she	she
s	s	s
a	a	a
big	big	big
hypocrite	hypocrit	hypocrite
in	in	in
this	this	this
interview	interview	interview
with	with	with
Bill	bill	Bill
Mayer	mayer	Mayer
