BREAKING	break	BREAKING
#TimKaine	#timkain	#TimKaine
rally	ralli	rally
only	onli	only
about	about	about
30	30	30
people	peopl	people
show	show	show
up	up	up
.	.	.

Her	her	Her
campaign	campaign	campaign
is	is	is
dead	dead	dead
in	in	in
#Florida	#florida	#Florida
nobody	nobodi	nobody
wants	want	want
#HillaryClinton	#hillaryclinton	#HillaryClinton
Serial	serial	Serial
Liar	liar	Liar
Corrupt	corrupt	Corrupt
pic.twitter.com/vgnWGHxXgs	pic.twitter.com/vgnwghxxg	pic.twitter.com/vgnWGHxXgs
Trump	trump	Trump
Street	street	Street
Team	team	Team
FL	fl	FL
@ChatRevolve	@chatrevolv	@ChatRevolve
October	octob	October
24	24	24
,	,	,
2016HILLARY	2016hillari	2016HILLARY
CAMPAIGN	campaign	CAMPAIGN
FREAKING	freak	FREAKING
OUT	out	OUT
AT	at	AT
TRUMP	trump	TRUMP
SUPPORTERS	support	SUPPORTERS
This	this	This
was	was	wa
halfway	halfway	halfway
during	dure	during
the	the	the
event	event	event
still	still	still
empty	empti	empty
and	and	and
Hillary	hillari	Hillary
staff	staff	staff
freaking	freak	freaking
out	out	out
over	over	over
us	us	u
shouting	shout	shouting
facts	fact	fact
#Trump2016	#trump2016	#Trump2016
#NV	#nv	#NV
#NC	#nc	#NC
#Ohio	#ohio	#Ohio
@jetsfan255	@jetsfan255	@jetsfan255
pic.twitter.com/JLvgGJWYUL	pic.twitter.com/jlvggjwyul	pic.twitter.com/JLvgGJWYUL
Trump	trump	Trump
Street	street	Street
Team	team	Team
FL	fl	FL
@ChatRevolve	@chatrevolv	@ChatRevolve
October	octob	October
25	25	25
,	,	,
2016	2016	2016

