Watch	watch	Watch
Tucker	tucker	Tucker
Carlson	carlson	Carlson
point	point	point
out	out	out
that	that	that
Trump	trump	Trump
paid	paid	paid
a	a	a
25	25	25
tax	tax	tax
rate	rate	rate
while	while	while
socialist	socialist	socialist
fair	fair	fair
share	share	share
Bernie	berni	Bernie
only	onli	only
paid	paid	paid
a	a	a
13	13	13
tax	tax	tax
rate	rate	rate
