However	howev	However
you	you	you
feel	feel	feel
about	about	about
Fiorina	fiorina	Fiorina
,	,	,
this	this	this
ad	ad	ad
takes	take	take
the	the	the
gloves	glove	glove
off	off	off
and	and	and
gives	give	give
Hillary	hillari	Hillary
a	a	a
big	big	big
smack	smack	smack
down	down	down
!	!	!

