Portland	portland	Portland
State	state	State
University	univers	University
held	held	held
its	it	it
second	second	second
Students	student	Students
for	for	for
Trump	trump	Trump
Rally	ralli	Rally
and	and	and
once	onc	once
again	again	again
the	the	the
radical	radic	radical
commies	commi	commie
and	and	and
racists	racist	racist
were	were	were
there	there	there
to	to	to
try	tri	try
and	and	and
shut	shut	shut
down	down	down
free	free	free
speech	speech	speech
.	.	.
