.	.	.
@rosadelauro	@rosadelauro	@rosadelauro
What	what	What
does	doe	doe
the	the	the
GOP	gop	GOP
stand	stand	stand
for	for	for
?	?	?
Get	get	Get
Old	old	Old
People	peopl	People
.	.	.
That	that	That
s	s	s
what	what	what
this	this	this
bill	bill	bill
does	doe	doe
.	.	.
pic.twitter.com/9ekkg0Nr5I	pic.twitter.com/9ekkg0nr5i	pic.twitter.com/9ekkg0Nr5I
Fox	fox	Fox
News	news	News
@FoxNews	@foxnew	@FoxNews
March	march	March
24	24	24
,	,	,
2017	2017	2017
