CNN	cnn	CNN
is	is	is
ridiculous	ridicul	ridiculous
but	but	but
this	this	this
is	is	is
insane	insan	insane
!	!	!
Check	check	Check
out	out	out
the	the	the
anchor	anchor	anchor
and	and	and
how	how	how
he	he	he
tries	tri	try
to	to	to
legitimize	legitim	legitimize
the	the	the
Iran	iran	Iran
ransom	ransom	ransom
unreal	unreal	unreal
!	!	!
