.	.	.
@DiamondandSilk	@diamondandsilk	@DiamondandSilk
have	have	have
something	someth	something
to	to	to
say	say	say
about	about	about
Kerry	kerri	Kerry
and	and	and
Obama	obama	Obama
stance	stanc	stance
on	on	on
Israel	israel	Israel
.	.	.

pic.twitter.com/d3xsU7hMHl	pic.twitter.com/d3xsu7hmhl	pic.twitter.com/d3xsU7hMHl
Diamond	diamond	Diamond
and	and	and
Silk	silk	Silk
@DiamondandSilk	@diamondandsilk	@DiamondandSilk
December	decemb	December
29	29	29
,	,	,
2016	2016	2016

