The	the	The
chants	chant	chant
started	start	started
as	as	a
Ryan	ryan	Ryan
addressed	address	addressed
the	the	the
crowd	crowd	crowd
without	without	without
mentioning	mention	mentioning
Trump	trump	Trump
s	s	s
name	name	name
.	.	.
Trump	trump	Trump
is	is	is
a	a	a
great	great	great
man	man	man
,	,	,
said	said	said
Scott	scott	Scott
Reese	rees	Reese
,	,	,
a	a	a
40	40	40
-year-old	-year-old	-year-old
plumber	plumber	plumber
sporting	sport	sporting
a	a	a
red	red	red
Make	make	Make
America	america	America
Great	great	Great
Again	again	Again
cap	cap	cap
.	.	.
We	we	We
all	all	all
make	make	make
mistakes	mistak	mistake
if	if	if
everybody	everybodi	everybody
understands	understand	understands
people	peopl	people
make	make	make
mistakes	mistak	mistake
,	,	,
then	then	then
this	this	this
shouldn	shouldn	shouldn
t	t	t
have	have	have
any	ani	any
effect	effect	effect
.	.	.
Shame	shame	Shame
on	on	on
Paul	paul	Paul
Ryan	ryan	Ryan
!	!	!
Crowd	crowd	Crowd
turns	turn	turn
on	on	on
Globalist	globalist	Globalist
Paul	paul	Paul
Ryan	ryan	Ryan
our	our	our
House	hous	House
CUCK	cuck	CUCK
leader	leader	leader
-	-	-
shouts	shout	shout
SHAME	shame	SHAME
ON	on	ON
YOU	you	YOU
!	!	!
pic.twitter.com/MjEYnwqi38	pic.twitter.com/mjeynwqi38	pic.twitter.com/MjEYnwqi38
Dr	dr	Dr
.	.	.
Hart	hart	Hart
for	for	for
#TRUMP!	#trump!	#TRUMP!
@ofccadjust	@ofccadjust	@ofccadjust
October	octob	October
8	8	8
,	,	,
2016	2016	2016
