Token	Stem	Lemma
Yes	yes	Yes
yes	yes	yes
yes	yes	yes
Tomi	tomi	Tomi
nails	nail	nail
it	it	it
again	again	again
Tomi	tomi	Tomi
goes	goe	go
at	at	at
it	it	it
with	with	with
a	a	a
radio	radio	radio
host	host	host
over	over	over
the	the	the
Black	black	Black
Panthers	panther	Panthers
and	and	and
Beyonce	beyonc	Beyonce
She	she	She
s	s	s
the	the	the
best	best	best
