Protester	protest	Protester
with	with	with
Rape	rape	Rape
sign	sign	sign
is	is	is
tackled	tackl	tackled
at	at	at
#Clinton	#clinton	#Clinton
rally	ralli	rally
in	in	in
#Las	#las	#Las
Vegas	vega	Vegas
pic.twitter.com/sJvGvFnpgt	pic.twitter.com/sjvgvfnpgt	pic.twitter.com/sJvGvFnpgt
John	john	John
Treanor	treanor	Treanor
@NewsTreanor	@newstreanor	@NewsTreanor
October	octob	October
13	13	13
,	,	,
2016	2016	2016

