Senate	senat	Senate
lifer	lifer	lifer
John	john	John
McCain	mccain	McCain
was	was	wa
caught	caught	caught
on	on	on
tape	tape	tape
complaining	complain	complaining
about	about	about
what	what	what
a	a	a
Trump	trump	Trump
candidacy	candidaci	candidacy
would	would	would
do	do	do
to	to	to
hurt	hurt	hurt
his	his	his
chances	chanc	chance
for	for	for
yet	yet	yet
another	anoth	another
reelection	reelect	reelection
