Token	Stem	Lemma
A	a	A
man	man	man
with	with	with
stickers	sticker	sticker
on	on	on
his	his	his
face	face	face
must	must	must
have	have	have
been	been	been
pretty	pretti	pretty
hungry	hungri	hungry
last	last	last
night	night	night
He	he	He
was	was	wa
the	the	the
hit	hit	hit
of	of	of
the	the	the
night	night	night
with	with	with
this	this	this
Vine	vine	Vine
going	go	going
viral	viral	viral
