Michael	michael	Michael
Moore	moor	Moore
seems	seem	seems
to	to	to
think	think	think
that	that	that
socialism	social	socialism
is	is	is
better	better	better
than	than	than
capitalism	capit	capitalism
He	he	He
Tweeted	tweet	Tweeted
out	out	out
last	last	last
night	night	night
that	that	that
socialism	social	socialism
is	is	is
about	about	about
fairness	fair	fairness
